NO textures/evil/no.xpm
SO textures/evil/so.xpm
WE textures/evil/we.xpm
EA textures/evil/ea.xpm

F              111,100,0
C              110,30,255

         111111111111111111111111111
         10000000001100000000000011
         110110000011100000000000111
         11111111100100000000000011
11111111111111111100000000001111111
100000000110000011101111111111111111
11110111111111011100000010001
11110111111111011101010010001
11000000110101011100000010001
1000000000000N001100000010001
10000000000000001101010010001
1100000111010101111101111000111
11111111 1111111 111111111111
11111111111111111111111111111