NO textures/2.xpm
SO textures/3.xpm
WE textures/5.xpm
EA textures/4.xpm

F 220,100,0
C 225,30,0

1111111111111111111111111
1000000000110000000000001
1011000001110000000000001
1001000000000000000000001
1111111110110000011100001
1000100000110000011101111
1111011111111101110000001
1111011111111101110101001
1100000011010101110000001
1000S00000000001100000001
1000000000000001101010011
1111111111111111111111111

