NO textures/nazi/2.xpm
SO textures/nazi/3.xpm
WE textures/nazi/5.xpm
EA textures/nazi/4.xpm

F 220,100,0
C 225,30,0

1111111111011111111111111
1000000000110000000000001
1011000001110000000000001
1001000000000000000000001
1111111110110000011100001
1000000000110000011101111
1111011111111100110000001
111101111111101110101001
110000001110101010000001
1000000001000001100000001
10S0001000000001101010011
1111111111111111111111111

