NO 			      textures/matrix.xpm
SO 			     textures/matrix.xpm
WE 		textures/matrix.xpm
EA 	textures/matrix.xpm	
C 0,0,0
F 0,0,0

1111111111111111111111111
1000000000110000000000001
1011000001110000000000001
1001000000000000000000001
1111111110110000011100001
1111111111111111111111111					
1111111111111111111111111
1000000000110000011101111
1111011111111100110000001
1111011111111011101010011
1100000111010101000000111
1000000001000001100000001
10S0100000000110101001111
1111111111111111111111111










